8 1 1 1 1 1 1 1 1 1
1 0 0 1 S 0 0 0 W 1
1 2 1 1 0 1 1 1 0 1
1 0 1 6 0 1 2 0 0 1
1 7 4 0 0 1 1 0 0 1
1 2 0 0 1 1 1 0 1 1
1 1 1 3 0 0 0 0 2 1
1 2 1 1 2 1 1 1 W 1
1 0 W 0 0 0 2 0 1 1
1 1 0 0 1 1 1 1 0 1
1 1 1 0 0 1 0 0 2 1
1 2 1 5 2 1 0 1 0 1
1 0 0 0 0 0 2 1 0 1
1 1 1 1 1 1 1 1 1 9