8 1 1 1 1 1 1 1 1 1
1 0 0 0 0 1 1 1 1 1
1 1 0 1 0 0 S 1 2 1
1 0 0 1 4 0 1 1 0 1
1 2 1 1 0 0 2 W 0 1
1 0 0 1 2 1 1 0 1 1
1 1 0 0 3 0 0 0 1 1
1 1 0 1 1 1 0 2 1 1
1 1 0 1 1 1 0 0 1 1
1 2 W 1 2 5 0 1 1 1
1 1 0 0 0 0 0 0 0 1
1 1 1 1 1 1 1 1 1 9