8 1 1 1 1 1 1 1 1 1
1 0 0 6 2 1 1 4 1 1
1 0 2 1 1 1 0 0 1 1
1 0 1 1 0 2 0 0 0 1
1 0 2 1 0 1 1 1 W 1
1 0 0 S 0 0 0 0 0 1
1 1 1 0 2 1 1 1 1 1
1 6 0 0 0 0 0 0 0 1
1 0 1 1 0 1 1 0 1 1
1 W 1 5 3 1 0 0 1 1
1 2 1 1 0 0 0 1 2 1
1 0 0 2 0 1 0 1 0 1
1 0 0 1 1 2 0 0 0 1
1 1 1 1 1 1 1 1 1 9