8 1 1 1 1 1 1 1 1 1
1 0 W 0 0 0 1 6 0 1
1 2 1 1 0 0 0 0 0 1
1 S 1 4 0 1 2 1 0 1
1 0 0 0 0 1 1 1 2 1
1 0 0 1 1 0 0 0 0 1
1 0 0 0 0 0 1 5 2 1
1 1 0 1 3 0 1 0 0 1
1 2 0 7 1 0 0 0 0 1
1 1 1 1 1 1 1 1 1 9